▤▤▤▤▤▤▤▤▤▤▤▤▤▤▤▤▤▤▤▤▤▤▤▤▤▤▤▤▤▤
▤☠     ☢▤                    ▤
▤ ▤▤▤▤▤ ▤            ♠  ⚿    ▤
▤ ▤   ▤      ☺ ☻             ▤
▤ ▤▤▤▤▤ ▤                    ▤
▤       ▤☢                   ▤
▤▤     ▤▤▤▤▤▤▤▤▤▤▤           ▤
▤☣      ▤        ▤           ▤
▤       ▤ ▤▤▤▤▤▤             ▤
▤    ☣  ▤      ▤▤▤           ▤
▤       ▤▤▤▤▤▤▤▤             ▤
▤☣      ▤      ▤ ▤▤▤▤▤----▤▤▤▤
▤       ▤ ▤▤▤▤ ▤  ▤■■■    ■■■▤
▤  ⚿    ▤ ▤▤      ▤■■■    ■■■▤
▤       ▤ ▤▤▤  ▤▤▤▤■■■    ■■■▤
▤▤▤▤▤▤▤▤▤    ▤    ▤■■■    ■■■▤
▤ ♠   ▤▤   ▤  ▤ ▤ ▤■■■    ■■■▤
▤▤▤ ▤▤▤▤  ▤▤▤ ▤▤▤ ▤■■■    ■■■▤
▤ ▤ ▤     ▤    ▤  ▤■■■    ■■■▤
▤ ▤ ▤▤▤▤▤▤▤ ▤  ▤  ▤■■■    ■■■▤
▤           ▤▤▤▤▤▤▤■■■    ■■■▤
▤ ▤▤▤▤ ▤▤▤        ▤■■■    ■■■▤
▤▤▤▤▤▤▤▤▤▤▤▤▤▤▤▤▤▤▤▤▤▤⍈⍈⍈⍈▤▤▤▤ 